NO ./texture/water.xpm
SO ./texture/lavafull.xpm
WE ./texture/liquid_green.xpm
EA ./texture/roof_gray.xpm


F 20,20,20
C 200,200,200

111111111111111111111111111111
100000000100000000100000000001
100000000100000000100000000001
100000000100000000100000000001
100000000000000000000000000001
100000000100000000100000000001
100000000100000000100000000001
100000000100000000100000000001
100000000100000000100000000001
111101111111110111111111011111
100000000100000000100000000001
100000000100000000100000000001
100000000100000000100000000001
100000000000000000000000000001
100000000100000000100000000001
100000000100000000100000000001
100000000100000000100000000001
100000000100000000100000000001
111101111111110111111111011111
1000S0000100000000100000000001
100000000100000000100000000001
100000000100000000100000000001
100000000000000000000000000001
100000000100000000100000000001
100000000100000000100000000001
100000000100000000100000000001
100000000100000000100000000001
100000000100000000100000000001
111111111111111111111111111111
