F 220,100,0
EA ./texture/test_texture.xpm

SO ./texture/test_texture.xpm

WE ./texture/test_texture.xpm

C 225,30,0
NO ./texture/test_texture.xpm

11111111111      
10000000001
11111111111
