F 220,100,0
EA ./imgs/tung_sahur.xpm

SO ./texture/test_texture.xpm

WE ./texture/test_texture.xpm

C 225,30,0
NO ./imgs/tung_sahur.xpm

   1111111111111111111111111
   1000000000110000000000001 
   1111000001110000000000001
   1001000000000000000001011111
11111111101000000111000000000001          
100000000011000001110111111111111111111111111
11110111111111011100000010001
11110111111111011101010010001
11000000110101011100000010001
10000000000000001100000010001
10000000000000001101010010001
11000001110101011111011110N0111
11110111 1110101 101111010001
11111111 1111111 111111111111
