NO ./texture/water.xpm
SO ./texture/lavafull.xpm
WE ./texture/liquid_green.xpm
EA ./texture/roof_gray.xpm


F 20,20,20
C 200,200,200

    1111111
    11110101
    100N1 11
    1111111