F 220,100,0
EA ./texture/test_texture.xpm

SO ./texture/test_texture.xpm

WE ./texture/test_texture.xpm

C 225,30,0
NO ./texture/test_texture.xpm

1111111111
1000000001
1000 00001
1011111111
1111111111
